10x20
********************
*       RR         *
****      *     ****
*         *        *
*        H         *
*                  *
*                  *
*                  *
*                  *
********************
