10x20  // 5 robots vs 1 player
********************
*  R        R      *
****            **** 
*        H  *      *
*   **     *   *   *
*   *      *  *    *
*     * *    R  *  *
****           *****
*     R      *     *
********************